NO textures/mur_4.xpm

SO textures/mur_1.xpm

EA textures/mur_5.xpm

WE textures/mur_b.xpm

F 222,111,000
C 000,111,222

1111111111111111111111111
1000000000110000000000001
1011000001110000000000001
1011000001110000002000001111
1001000000200000000000000001
1111111110110000011100000001
10000000001100000111000000011111111111111111111111111111111111111111111111
11112111121110111000000100001    10000000001000000000000000111100000000111
10000000001100000111211111111    10000000001000000000000000111111112211111
11112111121111011100000010001111110000000001000100000000000100000000000001
11111111121111011101010010002000000000000000000100000000000000000000000001
    110000011010101110000001000111111000000000100010000000000010000000001
    1000000000000001100000000000111111111111111111111111111111111111111111
    100N0000000000000001010100101
    11000001110101011111011110001
    11100111 1110101 101111010001
    11111111 1111111 111111111111