NO textures/mur_4.xpm

SO textures/mur_1.xpm

EA textures/mur_5.xpm

WE textures/mur_b.xpm

F 222,111,000
C 000,111,222

        1111111111111111111111111
        1000000000110000000000001
        1011000001110000000000001
        1011000001110000002000001111
        1001000000200000000000002001
111111111011000001110000000000002001
10000000001100000111011111111111110111111111111111111111111111111111111111
11112111111110111000000100001    10000000001000000000000000111100000000111
10000000001100000111211111111    10000000001000000000000000111111112211111
11112111111111011100000010001111110000000001000100000000000200000000000001
11112111111111011101010010002000000000000000000100000000000200000000000001
11000000110101011100000010001111110000000001000100000000000100000000000001
1000N000000000011000000000001111111111111111111111111111111111111111111111
10000000000000000001010100101
11000000110101011111011110001
11110111 1110101 101111010001
11111111 1111111 111111111111