NO textures/mur_r.xpm

SO textures/mur_g.xpm

EA textures/mur_b.xpm

WE textures/mur_y.xpm

F 222,111,000
C 000,111,222

        1111111111111111111111111
        1000000000110000000000001
        1011000001110000000000001
        1011000001110000002000001
        1001000000200000000000001
111111111011000001110000000000001
100000000011000001110111111111111
11112111111110111000000100001
100000000011000001112111111111111
11112111111111011100000010001
11112111111111011101010010001
11000000110101011100000010001
1000N00000000001100000000001
10000000000000000001010100101
1100000011010101111101111000111
11110111 1110101 101111010001
11111111 1111111 111111111111